+-+-+-+-+-+-+-+-+-+-+
|     | | | | | | | |
+-+-+ + + + + + + + +
|     | | | | | | | |
+ +-+-+ + + + + + + +
| | | | | | | | | | |
+ + + + + + + + + + +
|   | | | | | | | | |
+-+ + + + + + + + + +
|   | | | | | | | | |
+ +-+ + + + + + + + +
| | | | | | | | | | |
+ + + + + + + + + + +
| | |   | | | | | | |
+ + + + + + + + + + +
|     | | | |       |
+-+-+-+ + + + +-+-+ +
|     | | |   |     |
+ +-+-+ + + +-+ +-+-+
|           |       |
+-+-+-+-+-+-+-+-+-+-+