+-+-+-+-+-+-+-+-+-+-+
| | | | | | | | | | |
+ + + + + + + + + + +
|   | | | | | | | | |
+-+ + + + + + + + + +
| | | | | | | | | | |
+ + + + + + + + + + +
| | | | | | | | | | |
+ + + + + + + + + + +
| |   | | | | | | | |
+ +-+ + + + + + + + +
|   | | | | | | | | |
+ + + + + + + + + + +
| | | | | | | | | | |
+ + + + + + + + + + +
| | | | | | | | | | |
+ +-+ + + + + + + + +
| |   | | | | | | | |
+ + +-+ + + + + + + +
|                   |
+-+-+-+-+-+-+-+-+-+-+