+-+-+-+-+-+-+-+-+-+-+
| |   | | |   | | | |
+ + + + + + + + + + +
|   | | | | | | | | |
+-+-+ + + + + + + + +
| | | | | | |   | | |
+ + + + + + +-+ + + +
|     | | | | |   | |
+ +-+-+ + + + +-+ + +
| | |   |   | | |   |
+ + + + + +-+ + +-+ +
|     | | | | |   | |
+-+-+-+ + + + + +-+ +
| | | | | | | | |   |
+ + + + + + + + + +-+
| | | |   |   | |   |
+ + + +-+-+ + + +-+ +
| | |   | | | | |   |
+ + + +-+ + +-+ + +-+
|                   |
+-+-+-+-+-+-+-+-+-+-+