+-+-+-+-+-+-+-+-+-+-+
| | | | | | | | | | |
+ + + + + + + + + + +
|     | | | | | | | |
+-+-+ + + + + + + + +
| | | | | | | | | | |
+ + + + + + + + + + +
| | |         | | | |
+ + +-+-+-+-+ + + + +
| | | | | | | | | | |
+ + + + + + + + + + +
| | | | | | |   | | |
+ + + + + + +-+ + + +
| | | |   | | | | | |
+ + + + + + + + + + +
| | |   | | | |     |
+ + + +-+ + + +-+-+ +
| | | |   | | |     |
+ + + +-+-+ + + +-+-+
|                   |
+-+-+-+-+-+-+-+-+-+-+