+-+-+-+-+-+-+-+-+-+-+
| |   | | | | | | | |
+ + + + + + + + + + +
|   | |   | | |   | |
+-+-+ + + + + + + + +
| | | | | | |   |   |
+ + + + + + + +-+-+ +
| | | | |     |     |
+ + + + +-+-+-+ +-+-+
| | |   | | | |   | |
+ + +-+-+ + + +-+ + +
| | | | | | | | |   |
+ + + + + + + + +-+ +
| | | | | | | | |   |
+ + + + + + + + + +-+
|   | | | | | | |   |
+ + + + + + + + +-+ +
| | |   |     | | | |
+ +-+ +-+ +-+-+ + + +
|                   |
+-+-+-+-+-+-+-+-+-+-+